NO  ./map/North texture.xpm

SO  ./map/South_texture.xpm

WE   ./map/West_texture.xpm

EA  ./map/East_texture.xpm

F      255,255,   255

C      0, 0, 0

        111111111 11111111111111    
        100000001 10000000000111111
        110000111 101110111101100011111111111111
        10010000111000011  100011000000000000011
1111111110110000000000001  100000011111111111011      
1000000000110001111111111  11111111        1101
1111011111111101             10001         1101
11100111111110111 1111111111111111111      1001
11100000110S01011 10000001                 1011
  100000000000001 100000011111             1011
111000000000000111101010011111             1011
1111111111000111111110111111               1001
    101 1110101 10111101                   1001
    111 1111111 11111111                   1001
                                           1001
11111111111111111111111111111111111111111111001
10000000000000000000000000000000000000000000001
11111111111111111111111111111111111111111111111
